place of burial	place of burial
genre	genre
medical condition	medical condition
country	country
time period	time period
ethnic group	ethnic group
parent organization	parent organization
diplomatic relation	diplomatic relation
sport	sport
director	director
record label	record label
child	child
cause of death	cause of death
influenced by	influenced by
languages spoken, written, or signed	languages spoken, written, or signed
practiced by	practiced by
founded by	founded by
member of political party	member of political party
spouse	spouse
author	author
place of death	place of death
industry	industry
continent	continent
located in the administrative terroritorial entity	located in the administrative terroritorial entity
field of work	field of work
named after	named after
country of citizenship	country of citizenship
occupation	occupation
country of origin	country of origin
educated at	educated at
unmarried partner	unmarried partner
official language	official language
instrument	instrument
religion	religion
part of	part of
language of work or name	language of work or name
sibling	sibling
headquarters location	headquarters location
place of birth	place of birth
member of sports team	member of sports team
residence	residence
cast member	cast member
movement	movement
uses	uses
location of formation	location of formation
employer	employer
member of	member of
narrative location	narrative location
airline hub	airline hub
